6666666666
6555555556
6544444456
6533333356
6555555556
6666666666